1111111111
1PCCCE1001
1000001001
1111111111
